****************************************
****                         ****** ****
**** *********** *********** ****** ****
**** *********** ***       * ***    ****
P    *********** **  ***** * *** ** ****
**** ***      ** *  ******       ** ****
**** *** **** ** * **************** ****
**** *** **** **   **************** ****
**** *** **** ********************* ****
**** *** **                 ******* ****
**   ****** * *** ***************** ****
** ******** * ***                ** ****
** ******** * ********************* ****
** ******** * ********************* ****
**          * ********************* ****
***** ******* ********   ********** ****
***** ******* ********   ********** ****
*****      ** ********        ***** ****
************* ******** ****** ***** ****
************* ******** ****** ***** ****
*************          ****** **********
***************************** **********
*****************************          T
****************************************